좀 아쉽지만 같이 할만한 취미 새로 찾아보는것도 재미임. 아니면 나가서 놀다와라 시전해야지머.	좀/MAG 아쉽/VA-I 지만/EC 같이/MAG 하/VV ᆯ/ETM 만/NNB 하/XSA ᆫ/ETM 취미/NNG 새로/MAG 찾아보/VV 는/ETM 것/NNB 도/JX 재미/NNG 이/VCP ᆷ/ETN ./SF 아니/VCN 면/EC 나가/VV 어서/EC 놀/VV 다/EC 오/VV 어라/EC 시전/NNG 하/VV 어야지/EF 뭐/IC ./SF
애초에 카플이 될까??	애초/NNG 에/JKB 카풀/NNG 이/JKC 되/VV ᆯ까/EF ??/SF
사내에서 서로 호감이 있으면 어떻하든 엮이게 되어있음 회식 일찍 끝나서 아쉬운 마음에 둘이서 2차 갔다가 진짜 애휴.	사내/NNG 에서/JKB 서로/MAG 호감/NNG 이/JKS 있/VA 으면/EC 어떡하/VV 든/EC 엮이/VV 게/EC 되/VV 어/EC 있/VX 음/ETN 회식/NNG 일찍/MAG 끝나/VV 어서/EC 아쉽/VA-I 은/ETM 마음/NNG 에/JKB 둘/NR 이서/JKS 2/SN 차/NNB 가/VV 었/EP 다가/EC 진짜/MAG 에휴/IC ./SF
결혼하면 경제권 다 뺐기고 우울하다는 말만 들었는데 난 아주 많이 행운아 인가 봄...	결혼/NNG 하/XSV 면/EC 경제/NNG 권/XSN 다/MAG 뺏기/VV 고/EC 우울/NNG 하/XSA 다는/ETM 말/NNG 만/JX 듣/VV-I 었/EP 는데/EC 나/NP ᆫ/JX 아주/MAG 많이/MAG 행운아/NNG 이/VCP ᆫ가/EC 보/VX ᆷ/ETN .../SF
빨간색이 성능도 굉장히 좋은데 초록이가 난이도가 쉬워서 가려짐. 난무스킬이 커멘드에따라 막타가 두종류로 나뉘고 돌진스킬에 연계까지 되서 확정딜이 제일 쎔.	빨간색/NNG 이/JKS 성능/NNG 도/JX 굉장히/MAG 좋/VA 은데/EC 초록이/NNG 가/JKS 난이도/NNG 가/JKS 쉽/VA-I 어서/EC 가리/VV 어/EC 지/VX ᆷ/ETN ./SF 난무/NNG 스킬/NNG 이/JKS 커맨드/NNG 에/JKB 따르/VV 어/EC 막타/NNG 가/JKS 두/MM 종류/NNG 로/JKB 나뉘/VV 고/EC 돌진/NNG 스킬/NNG 에/JKB 연계/NNG 까지/JX 되/VV 어서/EC 확정/NNG 딜/NNG 이/JKS 제일/MAG 쎄/VA ᆷ/ETN ./SF
뭔가 하고는 있는데 개임개발자는 아니다 보니,	뭐/NP 이/VCP ᆫ가/EC 하/VV 고/EC 는/JX 있/VX 는데/EC 게임/NNG 개발자/NNG 는/JX 아니/VCN 다/EC 보/VX 니/EC ,/SP
원래 스마트한 엘리트 근육맨 케릭터인데 약때문에 멍청해지는거라서 에매함..	원래/MAG 스마트/NNG 하/XSV ᆫ/ETM 엘리트/NNG 근육맨/NNG 캐릭터/NNG 이/VCP ᆫ데/EC 약/NNG 때문/NNB 에/JKB 멍청하/VA 어/EC 지/VX 는/ETM 거/NNB 이/VCP 라서/EC 애매/XR 하/XSA ᆷ/ETN ../SF
어차피 실리콘은 안쪽으로 삽입되서 핏줄 잘보인다 목에 스카프나 초커같은거 두르고 있으면 의심해야댐.	어차피/MAG 실리콘/NNG 은/JX 안쪽/NNG 으로/JKB 삽입/NNG 되/XSV 어서/EC 핏줄/NNG 잘/MAG 보이/VV ᆫ다/EF 목/NNG 에/JKB 스카프/NNG 나/JC 초커/NNG 같/VA 은/ETM 거/NNB 두르/VV 고/EC 있/VX 으면/EC 의심/NNG 하/XSV 어야/EC 되/VV ᆷ/ETN ./SF
요즘엔 두발 자유화라 염색도 되나보던대요 나땐 2샌치 스포츠에 남중 남고 ㅠㅠ 요즘 학생들 부럽네요.	요즘/NNG 에/JKB ᆫ/JX 두발/NNG 자유/NNG 화/XSN 이/VCP 라/EC 염색/NNG 도/JX 되/VV 나/EC 보/VX 던데요/EC 나/NP 때/NNG ᆫ/JX 2/SN 센치/NNB 스포츠/NNG 에/JKB 남중/NNG 남고/NNG ㅠㅠ/SW 요즘/NNG 학생/NNG 들/XSN 부럽/VA-I 네요/EF ./SF
그랜져로 업글함	그랜저/NNG 로/JKB 업글/NNG 하/XSV ᆷ/ETN
중소의 특징은 위쪽은 가족 및 친족으로 체워져 있어서 밑층의 계급 구조가 얉아. 규모도 잦 같은 데가 전무, 상무, 이사,부장  이런 나부랭이급이 많고 실무 계급인 과장, 대리, 계장 배정인원 구조는 또 적어서 역피라미드인 경우도 흔함. 그러다보니, 과장 하나 올라가는 계단을 더 가파르게 만든 곳도 많다..	중소/NNG 의/JKG 특징/NNG 은/JX 위/NNG 쪽/NNB 은/JX 가족/NNG 및/MAJ 친족/NNG 으로/JKB 채우/VV 어/EC 지/VX 어/EC 있/VX 어서/EC 밑/NNG 층/XSN 의/JKG 계급/NNG 구조/NNG 가/JKS 얇/VA 어/EF ./SF 규모/NNG 도/JX 좆/NNG 같/VA 은/ETM 데/NNB 가/JKS 전무/NNG ,/SP 상무/NNG ,/SP 이사/NNG ,/SP 부장/NNG 이런/MM 나부랭이/NNG 급/NNG 이/JKS 많/VA 고/EC 실무/NNG 계급/NNG 이/VCP ᆫ/ETM 과장/NNG ,/SP 대리/NNG ,/SP 계장/NNG 배정/NNG 인원/NNG 구조/NNG 는/JX 또/MAG 적/VA 어서/EC 역/XPN 피라미드/NNG 이/VCP ᆫ/ETM 경우/NNG 도/JX 흔하/VA ᆷ/ETN ./SF 그러/VV 다/EC 보/VX 니/EC ,/SP 과장/NNG 하나/NR 올라가/VV 는/ETM 계단/NNG 을/JKO 더/MAG 가파르/VA 게/EC 만들/VV ᆫ/ETM 곳/NNG 도/JX 많/VA 다/EF ../SF
저게 주작같아보이면 중소를 아얘 경험안해본거 앞으로도 이쪽으로 오지말고 그쪽에서 행복해라	저것/NP 이/JKS 주작/NNG 같/VA 어/EC 보이/VV 면/EC 중소/NNG 를/JKO 아예/MAG 경험/NNG 안/MAG 하/VV 어/EC 보/VX ᆫ/ETM 거/NNB 앞/NNG 으로/JKB 도/JX 이/MM 쪽/NNB 으로/JKB 오/VV 지/EC 말/VX 고/EC 그쪽/NP 에서/JKB 행복/NNG 하/XSA 어라/EF
그럼 욕좀 할께. 정신차리고 꺼저라 제발.	그럼/IC 욕/NNG 좀/MAG 하/VV ᆯ께/EF ./SF 정신/NNG 차리/VV 고/EC 꺼지/VV 어라/EC 제발/MAG ./SF
이런상황에선 문제를 명확하게 정의하고 해결책을 재시 할 수 있는 사람이 인정을 받겠죠.. 매뉴얼 없다고 아몰랑 하는거보단.	이런/MM 상황/NNG 에서/JKB ᆫ/JX 문제/NNG 를/JKO 명확/XR 하/XSA 게/EC 정의/NNG 하/XSV 고/EC 해결책/NNG 을/JKO 제시/NNG 하/XSV ᆯ/ETM 수/NNB 있/VA 는/ETM 사람/NNG 이/JKS 인정/NNG 을/JKO 받/VV-R 겠/EP 죠/EF ../SF 매뉴얼/NNG 없/VA 다고/EC 아몰랑/NNP 하/VV 는/ETM 거/NNB 보다/JKB ᆫ/JX ./SF
얘를들면 사고를 쳤을때 내 선에서 처리했음. 상사가 잘 되가냐? 물어보면	예/NNG 를/JKO 들/VV 면/EC 사고/NNG 를/JKO 치/VV 었/EP 을/ETM 때/NNG 나/NP 의/JKG 선/NNG 에서/JKB 처리/NNG 하/XSV 었/EP 음/ETN ./SF 상사/NNG 가/JKS 잘/MAG 되/VV 어/EC 가/VX 냐/EF ?/SF 묻/VV-I 어/EC 보/VX 면/EC
솔직히 큰 업무들을 일개사원이 주먹구구식이다 나라면 이렇게할텐대 평가하는것도 웃낀일임	솔직히/MAG 크/VA ᆫ/ETM 업무/NNG 들/XSN 을/JKO 일개/NNG 사원/NNG 이/JKS 주먹구구식/NNG 이/VCP 다/EF 나/NP 이/VCP 라면/EC 이렇/VA 게/EC 하/VV ᆯ/ETM 터/NNB 이/VCP ᆫ데/EC 평가/NNG 하/XSV 는/ETM 것/NNB 도/JX 웃기/VV ᆫ/ETM 일임/NNG
아안되!!! 그럼 진화해서 닭이된다고!!!!!	아/IC 안/MAG 되/VV 어/EF !!!/SF 그럼/MAJ 진화/NNG 하/XSV 어서/EC 닭/NNG 이/JKC 되/VV ᆫ다고/EC !!!!!/SF
어차피 점잔케 말해도 못 알아 들을탠데 무슨 상관이 있을까	어차피/MAG 점잖/VA 게/EC 말/NNG 하/XSV 어도/EC 못/MAG 알/VV 어/EC 듣/VV-I 을/ETM 터/NNB 이/VCP ᆫ데/EC 무슨/MM 상관/NNG 이/JKS 있/VV 을까/EF
이거 원래 뒤편이 이리 엑티브했냐?	이거/NP 원래/MAG 뒤편/NNG 이/JKS 이리/MAG 액티브/NNG 하/XSV 었/EP 냐/EF ?/SF
두가지 요소를 이야기하고 싶은데 첫쨰로 피로골절의 시대라고 생각함	두/MM 가지/NNB 요소/NNG 를/JKO 이야기/NNG 하/XSV 고/EC 싶/VX 은데/EC 첫째/NR 로/JKB 피로/NNG 골절/NNG 의/JKG 시대/NNG 이/VCP 라고/EC 생각/NNG 하/XSV ᆷ/ETN
물론 거기에 휩슬린 네가 말하는 민감한 중간층도 있겠지만	물론/MAG 거기/NP 에/JKB 휩쓸리/VV ᆫ/ETM 너/NP 가/JKS 말/NNG 하/XSV 는/ETM 민감/XR 하/XSA ᆫ/ETM 중간/NNG 층/XSN 도/JX 있/VV 겠/EP 지만/EC
반응이 즉각 오는게 아니라 자기객관화 안돼면 고생만 오지게 하다가 욕보는 요식업..	반응/NNG 이/JKS 즉각/MAG 오/VV 는/ETM 것/NNB 이/JKC 아니/VCN 라/EC 자기/NP 객관/NNG 화/XSN 안/MAG 되/VV 면/EC 고생/NNG 만/JX 오지/VA 게/EC 하/VV 다가/EC 욕보/VV 는/ETM 요식업/NNG ../SF
근데 저기는 직원수도 더 많고 프렌차이즈치킨과 다르게 직접준비하는게 많을거라 좀 아슬아슬할듯	근데/MAJ 저기/NP 는/JX 직원/NNG 수/NNG 도/JX 더/MAG 많/VA 고/EC 프랜차이즈/NNG 치킨/NNG 과/JKB 다르/VA 게/EC 직접/MAG 준비/NNG 하/XSV 는/ETM 것/NNB 이/JKS 많/VA 을/ETM 거/NNB 이/VCP 라/EC 좀/MAG 아슬아슬/MAG 하/XSA ᆯ/ETM 듯/NNB
이거 옜날에 다른 탄산보다 싸서 자주 맛나게 먹었었는데	이거/NP 옛날/NNG 에/JKB 다른/MM 탄산/NNG 보다/JKB 싸/VV 어서/EC 자주/MAG 맛나/VA 게/EC 먹/VV 었었/EP 는데/EC
롤러코스터 재대로 태우시네 ㅋㅋㅋㅋ	롤러코스터/NNG 제대로/MAG 태우/VV 시/EP 네/EF ㅋㅋㅋㅋ/SW
다들 생각한거랑틀려서 실망해찌 나도야 ㅋㅋㅋㅋㅋㅋㅋ 줜나웃기네	다/MAG 들/XSN 생각/NNG 하/XSV ᆫ/ETM 거/NNB 랑/JKB 틀리/VA 어서/EC 실망/NNG 하/XSV 었/EP 지/EF 나/NP 도/JX 야/JX ㅋㅋㅋㅋㅋㅋㅋ/SW 존나/MAG 웃기/VV 네/EF
어째 불나면 유리라도 깨서 연기라도 빼던가 구출을하던가해야할텐데 질식해서 죽을것같이 불안하네	어째/MAG 불/NNG 나/VV 면/EC 유리/NNG 이/VCP 라도/EC 깨/VV 어서/EC 연기/NNG 이/VCP 라도/EC 빼/VV 든가/EC 구출/NNG 을/JKO 하/VV 든가/EC 하/VV 어야/EC 하/VX ᆯ/ETM 터/NNB 이/VCP ᆫ데/EC 질식/NNG 하/XSV 어서/EC 죽/VV 을/ETM 것/NNB 같이/JKB 불안/NNG 하/XSA 네/EF
실제로는 해상도 더 낮고 텍스쳐도 더 뭉게보일껄	실제로/MAG 는/JX 해상도/NNG 더/MAG 낮/VA 고/EC 텍스처/NNP 도/JX 더/MAG 뭉개/VV 어/EC 보이/VV ᆯ걸/EF
그걸 가만해도 그냥 몸치임. 무술 경력은 고사하고 건강용 체조만 했어도 저따위론 안함.	그거/NP ᆯ/JKO 감안/NNG 하/XSV 어도/EC 그냥/MAG 몸치/NNG 이/VCP ᆷ/ETN ./SF 무술/NNG 경력/NNG 은/JX 고사하고/MAG 건강/NNG 용/XSN 체조/NNG 만/JX 하/VV 었/EP 어도/EC 저/MM 따위/NNB 로/JKB ᆫ/JX 안/MAG 하/VV ᆷ/ETN ./SF
이걸 증명하면 모든 컴퓨터 보안쳬계가 바뀜. P=NP를 증명하는 순간 거이 모든 암호체계가 무너질텐데	이거/NP ᆯ/JKO 증명/NNG 하/XSV 면/EC 모든/MM 컴퓨터/NNG 보안/NNG 체계/NNG 가/JKS 바뀌/VV ᆷ/ETN ./SF P/SL =/SW NP/SL 를/JKO 증명/NNG 하/XSV 는/ETM 순간/NNG 거의/MAG 모든/MM 암호/NNG 체계/NNG 가/JKS 무너지/VV ᆯ/ETM 터/NNB 이/VCP ᆫ데/EC
넘버 조회 해봐야 체굴인지 아닌지 알수잇다는데 넘버까지 조작하면 그냥 새거 없다고 보면 되겠네	넘버/NNG 조회/NNG 하/XSV 어/EC 보/VX 어야/EC 채굴/NNG 이/VCP ᆫ지/EC 아니/VCN ᆫ지/EC 알/VV ᆯ/ETM 수/NNB 있/VA 다는데/EC 넘버/NNG 까지/JX 조작/NNG 하/XSV 면/EC 그냥/MAG 새/MM 거/NNB 없/VA 다고/EC 보/VV 면/EC 되/VV 겠/EP 네/EF
물로는씻어봤는대 초음파세척해도괜찮나보넹 ㅋㅋㅋ	물/NNG 로/JKB 는/JX 씻/VV-R 어/EC 보/VX 었/EP 는데/EC 초음파/NNG 세척/NNG 하/XSV 어도/EC 괜찮/VA 나/EC 보/VX 넹/EF ㅋㅋㅋ/SW
걍 사기꾼 색기들 집단인데 못잡아 쳐넣나	걍/MAG 사기꾼/NNG 새끼/NNG 들/XSN 집단/NNG 이/VCP ᆫ데/EC 못/MAG 잡/VV-R 어/EC 처넣/VV 나/EC
이러다 나 진짜 할아버지가 되버려용	이러/VV 다/EC 나/NP 진짜/MAG 할아버지/NNG 가/JKC 되/VV 어/EC 버리/VX 어용/EF
기자들이 이런거 파해치는게 일 아닌가	기자/NNG 들/XSN 이/JKS 이런/MM 거/NNB 파헤치/VV 는/ETM 것/NNB 이/JKS 일/NNG 아니/VCN ᆫ가/EF
마! 이쁜이센드위치 모르나! 저거 왜 다 녹앗냐ㅋㅋㅋㅋㅋㅋㅋㅋㅋㅋㅋㅋ	마/NNG !/SF 이쁜이/NNP 샌드위치/NNG 모르/VV 나/EF !/SF 저거/NP 왜/MAG 다/MAG 녹/VV 었/EP 냐/EF ㅋㅋㅋㅋㅋㅋㅋㅋㅋㅋㅋㅋ/SW
좀 꾸미면 왜 애꺼 뻇어 입었냐 소리 나옴. 지금쯤 머하고 있을까	좀/MAG 꾸미/VV 면/EC 왜/MAG 애/NNG 꺼/NNB 뺏/VV-R 어/EC 입/VV-R 었/EP 냐/EC 소리/NNG 나오/VV ᆷ/ETN ./SF 지금/NNG 쯤/XSN 뭐/NP 하/VV 고/EC 있/VX 을까/EF
마이클 젝슨 소환영 촉메제로 봉인지정?	마이클/NNP 잭슨/NNP 소환/NNG 용/XSN 촉매제/NNG 로/JKB 봉인/NNG 지정/NNG ?/SF
정말 자기관리를 잘해서 피부도 몸매도 좋으면.... 저기에 글쓸떄까지 감안히 놔둘리 없다....	정말/MAG 자기/NNG 관리/NNG 를/JKO 잘/MAG 하/XSV 어서/EC 피부/NNG 도/JX 몸매/NNG 도/JX 좋/VA 으면/EC ..../SF 저기/NP 에/JKB 글/NNG 쓰/VV ᆯ/ETM 때/NNG 까지/JX 가만히/MAG 놔두/VV ᆯ/ETM 리/NNB 없/VA 다/EF ..../SF
20대까진 내구도가 달아도 수리하면 다 수리되눈 느낌임 30/100까지 달아도 휴식하면 100/100이 되는데 30대부턴 휴식을 해도 최대 내구도가 닳는 느낌이야 운동은 그 차감치를 줄여주는거고 때에 따라선 회복되기도 하는거 같아	20/SN 대/NNB 까지/JX ᆫ/JX 내구도/NNG 가/JKS 닳/VV 어도/EC 수리/NNG 하/XSV 면/EC 다/MAG 수리/NNG 되/XSV 는/ETM 느낌/NNG 이/VCP ᆷ/ETN 30/SN //SP 100/SN 까지/JX 닳/VV 어도/EC 휴식/NNG 하/XSV 면/EC 100/SN //SP 100/SN 이/JKC 되/VV 는/ETM 데/NNB 30/SN 대/NNB 부터/JX ᆫ/JX 휴식/NNG 을/JKO 하/VV 어도/EC 최대/NNG 내구도/NNG 가/JKS 닳/VV 는/ETM 느낌/NNG 이/VCP 야/EC 운동/NNG 은/JX 그/MM 차감/NNG 치/XSN 를/JKO 줄이/VV 어/EC 주/VX 는/ETM 거/NNB 이/VCP 고/EC 때/NNG 에/JKB 따르/VV 어서/EC ᆫ/JX 회복/NNG 되/XSV 기/ETN 도/JX 하/VX 는/ETM 거/NNB 같/VA 어/EF
참고로 박준형 학력 캘리포니아 주립대 그래픽디자인 학사	참고/NNG 로/JKB 박준형/NNP 학력/NNG 캘리포니아/NNP 주립대/NNG 그래픽/NNG 디자인/NNG 학사/NNG
인구수 많으면 뭐하는데 도시는 빛더미지, 코로나때도 제대로된 지원도 거의 없었지	인구/NNG 수/NNG 많/VA 으면/EC 뭐/NP 하/VV 는데/EF 도시/NNG 는/JX 빚더미/NNG 이/VCP 지/EC ,/SP 코로나/NNP 때/NNG 도/JX 제대로/MAG 되/VV ᆫ/ETM 지원/NNG 도/JX 거의/MAG 없/VA 었/EP 지/EF
부평공장 빠지면 역근처 재에하고는 부평 한동안 진짜 휑하겠내요  서구가는 길목은 진짜 건물들 다오래됬던데	부평/NNP 공장/NNG 빠지/VV 면/EC 역/NNG 근처/NNG 제외/NNG 하고/JKB 는/JX 부평/NNP 한/MM 동안/NNG 진짜/MAG 휑하/VA 겠/EP 네요/EF 서구/NNP 가/VV 는/ETM 길목/NNG 은/JX 진짜/MAG 건물/NNG 들/XSN 다/MAG 오래되/VA 었/EP 던/ETM 데/NNB
다른 기관의 도움을 받는다는게 툭까놓고 말해서 협조요청에 일정조절에 안전대책에 분배방법에 그러면 그 도움받는동안 그 다른기관이 하던일은 어떻게 될것인가부터 어떻게 얼마나 누가 일을 할건가까지 전부 다 결정해야하는데 회의에 회의를 거져 다 정해져도 최소 한두달 이상 걸림 진짜. 관료제라는게 정말로 비리를 방지하기 위해 권한을 쪼개고 쪼개고 또 쪼개버렸기 때문에 말처럼 그렇게 쉽게 협조를 할 수 있는게 아니라..	다른/MM 기관/NNG 의/JKG 도움/NNG 을/JKO 받/VV-R 는다는/ETM 것/NNB 이/JKS 툭/MAG 까놓/VV 고/EC 말/NNG 하/XSV 어서/EC 협조/NNG 요청/NNG 에/JKB 일정/NNG 조절/NNG 에/JKB 안전/NNG 대책/NNG 에/JKB 분배/NNG 방법/NNG 에/JKB 그러면/MAJ 그/MM 도움/NNG 받/VV-R 는/ETM 동안/NNG 그/MM 다른/MM 기관/NNG 이/JKS 하/VV 던/ETM 일/NNG 은/JX 어떻/VA 게/EC 되/VV ᆯ/ETM 것/NNB 이/VCP ᆫ가/EF 부터/JX 어떻/VA 게/EC 얼마나/MAG 누/NP 가/JKS 일/NNG 을/JKO 하/VV ᆯ/ETM 거/NNB 이/VCP ᆫ가/EC 까지/JX 전부/MAG 다/MAG 결정/NNG 하/XSV 어야/EC 하/VX 는/ETM 데/NNB 회의/NNG 에/JKB 회의/NNG 를/JKO 거치/VV 어/EC 다/MAG 정하/VV 어/EC 지/VX 어도/EC 최소/NNG 한두/MM 달/NNG 이상/NNG 걸리/VV ᆷ/ETN 진짜/MAG ./SF 관료/NNG 제/XSN 이/VCP 라는/ETM 것/NNB 이/JKS 정말로/MAG 비리/NNG 를/JKO 방지/NNG 하/XSV 기/ETN 위하/VV 어/EC 권한/NNG 을/JKO 쪼개/VV 고/EC 쪼개/VV 고/EC 또/MAG 쪼개/VV 어/EC 버리/VX 었/EP 기/ETN 때문/NNB 에/JKB 말/NNG 처럼/JKB 그렇/VA 게/EC 쉽/VA-I 게/EC 협조/NNG 를/JKO 하/VV ᆯ/ETM 수/NNB 있/VA 는/ETM 것/NNB 이/JKC 아니/VCN 라/EC ../SF
공대 매커니즘으로는 정상이지. 깔아뭉게는걸 즐겨함....	공대/NNG 메커니즘/NNG 으로/JKB 는/JX 정상/NNG 이/VCP 지/EF ./SF 깔아뭉개/VV 는/ETM 거/NNB ᆯ/JKO 즐기/VV 어/EC 하/VX ᆷ/ETN ..../SF
살려죠	살리/VV 어/EC 주/VX 어/EF
존나 빡치는 일 있었나보다 싶음.. 사회 생활하면서 빡치는 일 있어서 왠만하면 참는데 저정도면 뭐..	존나/MAG 빡/MAG 치/VV 는/ETM 일/NNG 있/VA 었/EP 나/EC 보/VX 다/EF 싶/VX 음/ETN ../SF 사회/NNG 생활/NNG 하/VV 면서/EC 빡/MAG 치/VV 는/ETM 일/NNG 있/VA 어서/EC 웬만/XR 하/XSA 면/EC 참/VV 는데/EC 저/MM 정도/NNG 이/VCP 면/EC 뭐/IC ../SF
구매팀 한명이 총대매고 공론화시킬려고 저럴수도 있음.	구매/NNG 팀/NNG 한/MM 명/NNB 이/JKS 총대/NNG 메/VV 고/EC 공론/NNG 화/XSN 시키/VV ᆯ려고/EC 저러/VV ᆯ/ETM 수/NNB 도/JX 있/VA 음/ETN ./SF
내 커리어를 재물로 바쳐서 신입을 갈군다!	나/NP 의/JKG 커리어/NNG 를/JKO 제물/NNG 로/JKB 바치/VV 어서/EC 신입/NNG 을/JKO 갈구/NNG ᆫ다/EF !/SF
저거는 혼밥아니면 무례한개 맞다	저거/NP 는/JX 혼밥/NNG 아니/VCN 면/EC 무례/NNG 하/XSA ᆫ/ETM 것/NNB 이/JKS 맞/VV 다/EF
나 첨에 입대할때  자대 양주?로 배치받앗는데 와 경기도네 ㅋㅋ 개꿀 햇는데 체전방이던데 ㅋㅋㅋㅋㅋㅋ	나/NP 첨/NNG 에/JKB 입대/NNG 하/XSV ᆯ/ETM 때/NNG 자대/NNG 양주/NNP ?/SF 로/NNG 배치/NNG 받/VV-R 었/EP 는데/EC 와/IC 경기도/NNP 이/VCP 네/XSN ㅋㅋ/SW 개/XPN 꿀/NNG 하/XSV 었/EP 는데/EC 최/XPN 전방/NNG 이/VCP 던데/EF ㅋㅋㅋㅋㅋㅋ/SW
다만 당신이 제시한 초단기간 근로자가 많은 직군 중에 카페, 편의점를 제외하면 본문에 언급되는 20대 초반이 주로 하는 직군이 아니자너.	다만/MAG 당신/NP 이/JKS 제시/NNG 하/XSV ᆫ/ETM 초/XPN 단기간/NNG 근로자/NNG 가/JKS 많/VA 은/ETM 직군/NNG 중/NNB 에/JKB 카페/NNG ,/SP 편의점/NNG 을/JKO 제외/NNG 하/XSV 면/EC 본문/NNG 에/JKB 언급/NNG 되/XSV 는/ETM 20/SN 대/NNB 초반/NNG 이/JKS 주로/MAG 하/VV 는/ETM 직군/NNG 이/JKS 아니/VCN 잖어/EF ./SF
그냥 기본이 안되있따는거지 몬 호구야 직장도 잘하고 못하고를 떠나 일 배울생각도 없이 월급루팡짓 할려면 짤려	그냥/MAG 기본/NNG 이/JKC 안/MAG 되/VV 어/EC 있/VX 다는/ETM 거/NNB 이/VCP 지/EC 뭔/MM 호구/NNG 야/JX 직장/NNG 도/JX 잘/MAG 하/XSV 고/EC 못하/VX 고/EC 를/JKO 떠나/VV 어/EC 일/NNG 배우/VV ᆯ/ETM 생각/NNG 도/JX 없이/MAG 월급루팡/NNG 짓/XSN 하/VV ᆯ려면/EC 짤리/VV 어/EF
그리고 집 화장실은 자주 청소하는거 아니면 그렇게 튄 오줌 떄문에 화장실에서 냄세도 나게되고	그리고/MAJ 집/NNG 화장실/NNG 은/JX 자주/MAG 청소/NNG 하/XSV 는/ETM 거/NNB 아니/VCN 면/EC 그렇/VA 게/EC 튀/VV ᆫ/ETM 오줌/NNG 때문/NNB 에/JKB 화장실/NNG 에서/JKB 냄새/NNG 도/JX 나/VV 게/EC 되/VV 고/EC
내가 알고 있는 회사만해도 지방에 있던 공장들은 없엘수 있으면 없애고 해외로 뺴버리고  연구인력, 새로 국내에 지을 생산라인은 죄다 경기도로 옯겨버림	나/NP 가/JKS 알/VV 고/EC 있/VX 는/ETM 회사/NNG 만/JX 하/VV 어도/EC 지방/NNG 에/JKB 있/VA 던/ETM 공장/NNG 들/XSN 은/JX 없애/VV ᆯ/ETM 수/NNB 있/VA 으면/EC 없애/VV 고/EC 해외/NNG 로/JKB 빼/VV 어/EC 버리/VX 고/EC 연구/NNG 인력/NNG ,/SP 새로/MAG 국내/NNG 에/JKB 짓/VV-I 을/ETM 생산/NNG 라인/NNG 은/JX 죄다/MAG 경기도/NNP 로/JKB 옮기/VV 어/EC 버리/VX ᆷ/ETN
자신들은 안죶된다고 생각하은데 왜 그러겠어	자신/NNG 들/XSN 은/JX 안/MAG 좆/NNG 되/XSV ᆫ다고/EC 생각/NNG 하/XSV 는/ETM 데/NNB 왜/MAG 그러/VV 겠/EP 어/EF
실제론 독재자가 수도권에 이권을 많이 가진 사람일 확율이 더 높겠지	실제로/MAG ᆫ/JX 독재자/NNG 가/JKS 수도/NNG 권/XSN 에/JKB 이권/NNG 을/JKO 많이/MAG 가지/VV ᆫ/ETM 사람/NNG 이/VCP ᆯ/ETM 확률/NNG 이/JKS 더/MAG 높/VA 겠/EP 지/EF
없에려면 기간을 좀 두고해야겠지 막없에고 땡인게 아니니까	없애/VV 려면/EC 기간/NNG 을/JKO 좀/MAG 두/VV 고/EC 하/VV 어야/EC 겠/EP 지/EF 막/MAG 없애/VV 고/EC 땡/NNG 이/VCP ᆫ/ETM 것/NNB 이/JKC 아니/VCN 니까/EC
소리를 좀 높혀봐	소리/NNG 를/JKO 좀/MAG 높이/VV 어/EC 보/VX 어/EF
문디새끼 니 속꼬만 살았나?	문디/NNG 새끼/NNG 니/NP 속/VV 고/EC 만/JX 살/VV 었/EP 나/EC ?/SF
물론 드래곤볼이 해마다 게임이 나와재끼고 굿즈도 겁나 팔아재끼는 컨탠츠인건 감안하고..	물론/MAG 드래곤볼/NNP 이/JKS 해/NNG 마다/JX 게임/NNG 이/JKS 나오/VV 어/EC 제끼/VX 고/EC 굿즈/NNG 도/JX 겁나/MAG 팔/VV 어/EC 제끼/VV 는/ETM 컨텐츠/NNG 이/VCP ᆫ/ETM 거/NNB ᆫ/JX 감안/NNG 하/XSV 고/EC ../SF
존나 시원하게 까네요 속이 뚤리는 느낌 ㅋㅋㅋ	존나/MAG 시원/XR 하/XSA 게/EC 까/VV 네/EF 요/JX 속/NNG 이/JKS 뚫리/VV 는/ETM 느낌/NNG ㅋㅋㅋ/SW
버스랑 왼쪽에 잇는 차 위치를 봐라 은행중인가	버스/NNG 랑/JC 왼쪽/NNG 에/JKB 있/VA 는/ETM 차/NNG 위치/NNG 를/JKO 보/VV 어라/EC 운행/NNG 중/NNB 이/VCP ᆫ가/EF
면허는 따고 지껄이는 거냐. 블박차량이 파란불 직진 신호에 직진하고 있는데	면허/NNG 는/JX 따/VV 고/EC 지껄이/VV 는/ETM 거/NNB 이/VCP 냐/EF ./SF 블박/NNG 차량/NNG 이/JKS 파란불/NNG 직진/NNG 신호/NNG 에/JKB 직진/NNG 하/XSV 고/EC 있/VX 는데/EC
막판에 헨들도 꺾어서 저 상황에서 사거리 전방주시 미흡이 과실로 적용댈 수 있나..	막판/NNG 에/JKB 핸들/NNG 도/JX 꺾/VV 어서/EC 저/MM 상황/NNG 에서/JKB 사거리/NNG 전방/NNG 주시/NNG 미흡/NNG 이/JKS 과실/NNG 로/JKB 적용/NNG 되/XSV ᆯ/ETM 수/NNB 있/VA 나/EC ../SF
군의관 뽑는기준이 어떻길레 저러는건가요?	군의관/NNG 뽑/VV-R 는/ETM 기준/NNG 이/JKS 어떻/VA 길래/EC 저러/VV 는/ETM 거/NNB 이/VCP ᆫ가/EF 요/JX ?/SF
애초에 직업군인형 의사를 꼿을수없으니 더더욱 그렇고	애초/NNG 에/JKB 직업/NNG 군인/NNG 형/XSN 의사/NNG 를/JKO 꽂/VV 을/ETM 수/NNB 없/VA 으니/EC 더더욱/MAG 그렇/VA 고/EC
하지만 우리나라에서는 그런 생각을 가질수있는 환경이 충분이 조성되있다는걸 알아야한다는겁니다. 그러므로 원글에 나오는 디자인한 디자이너의 태도가 잘못됬다는거죠. 님한테 뭘 바라는건 없습니다. 다만 폭 넖게 생각하시라는거죠.	하지만/MAJ 우리나라/NNG 에서/JKB 는/JX 그런/MM 생각/NNG 을/JKO 가지/VV ᆯ/ETM 수/NNB 있/VA 는/ETM 환경/NNG 이/JKS 충분히/MAG 조성/NNG 되/XSV 어/EC 있/VX 다는/ETM 거/NNB ᆯ/JKO 알/VV 어야/EC 하/VX ᆫ다는/ETM 거/NNB 이/VCP ᆸ니다/EF ./SF 그러므로/MAJ 원/XPN 글/NNG 에/JKB 나오/VV 는/ETM 디자인/NNG 하/XSV ᆫ/ETM 디자이너/NNG 의/JKG 태도/NNG 가/JKS 잘못/MAG 되/XSV 었/EP 다는/ETM 거/NNB 이/VCP 죠/EF ./SF 님/NNG 한테/JKB 뭐/NP ᆯ/JKO 바라/VV 는/ETM 거/NNB ᆫ/JX 없/VA 습니다/EF ./SF 다만/MAG 폭/NNG 넓/VA 게/EC 생각/NNG 하/XSV 시/EP 라는/ETM 거/NNB 이/VCP 죠/EF ./SF
이러니까 사적재재에 사람들이 열광하지 그냥 좋아하겠냐	이러/VV 니까/EC 사/NNG 적/XSN 제재/NNG 에/JKB 사람/NNG 들/XSN 이/JKS 열광/NNG 하/XSV 지/EF 그냥/MAG 좋아하/VV 겠/EP 냐/EF
보복을 위해 있는게 교도소가 아니니까 거기다 고통을 주는.방법을 저런 원시적인 수단을 쓸 필요도 없고 관리가 안되는 환경일수록 좋은 일더 없다고 생각함. 내부 치안이단 교도소내의 계급사회던 간에 악영할게.늘어난다고 봄	보복/NNG 을/JKO 위하/VV 어/EC 있/VX 는/ETM 것/NNB 이/JKS 교도소/NNG 가/JKC 아니/VCN 니까/EC 거기/NP 다/JX 고통/NNG 을/JKO 주/VV 는/ETM ./SF 방법/NNG 을/JKO 저런/MM 원시/NNG 적/XSN 이/VCP ᆫ/ETM 수단/NNG 을/JKO 쓰/VV ᆯ/ETM 필요/NNG 도/JX 없/VA 고/EC 관리/NNG 가/JKS 안/MAG 되/VV 는/ETM 환경/NNG 이/VCP ᆯ수록/EC 좋/VA 은/ETM 일/NNG 도/JX 없/VA 다고/EC 생각/NNG 하/XSV ᆷ/ETN ./SF 내부/NNG 치안/NNG 이/VCP 든/EC 교도소/NNG 내/NNB 의/JKG 계급/NNG 사회/NNG 이/VCP 든/EC 간/NNB 에/JKB 악용/NNG 하/XSV ᆯ게/EF ./SF 늘어나/VV ᆫ다고/EC 보/VV ᆷ/ETN
문제는 더빙이 무슨 매화마다 드믄드믄 되어있는게 있는거보고 어이없어서 ㅋㅋㅋ	문제/NNG 는/JX 더빙/NNG 이/JKS 무슨/MM 매/MM 화/NNG 마다/JX 드문드문/MAG 되/VV 어/EC 있/VX 는/ETM 것/NNB 이/JKS 있/VV 는/ETM 거/NNB 보/VV 고/EC 어이없/VA 어서/EC ㅋㅋㅋ/SW
솔직히 디즈니+ 들어오고 나서 기묘한 이야기나 러브데스로봇처럼 하나라도 머 어디 약팔이할 물건이 당췌 안보임.	솔직히/MAG 디즈니+/NNP 들어오/VV 고/EC 나/VX 어서/EC 기묘/XR 하/XSA ᆫ/ETM 이야기/NNG 나/JC 러브/NNG 데스/NNG 로봇/NNG 처럼/JKB 하나/NR 이/VCP 라도/EC 뭐/IC 어디/IC 약팔이/NNG 하/XSV ᆯ/ETM 물건/NNG 이/JKS 당최/MAG 안/MAG 보이/VV ᆷ/ETN ./SF
그건 아는데 지들끼리 짝짜꿍 하더라도 개같지만 말은 되는 똥딱개 논리가 법적으로 뭔가 있을거 아냐 저새끼가 똥먹었습니다. 똥 묻은 빵이랑 그게 입으로 들어가는 사진 다 찍었습니다 했는데 안먹었다고 잡아때려면 그냥 우기는게 아니라	그거/NP ᆫ/JX 알/VV 는데/EC 지/NP 들/XSN 끼리/XSN 짝자꿍/NNG 하/VV 더라도/EC 개/NNG 같/VA 지만/EC 말/NNG 은/JX 되/VV 는/ETM 똥/NNG 닦개/NNG 논리/NNG 가/JKS 법/NNG 적/XSN 으로/JKB 뭐/NP 이/VCP ᆫ가/EF 있/VA 을/ETM 거/NNB 아니/VCN 야/EF 저/MM 새끼/NNG 가/JKS 똥/NNG 먹/VV 었/EP 습니다/EF ./SF 똥/NNG 묻/VV-R 은/ETM 빵/NNG 이랑/JC 그것/NP 이/JKS 입/NNG 으로/JKB 들어가/VV 는/ETM 사진/NNG 다/MAG 찍/VV 었/EP 습니다/EF 하/VV 었/EP 는데/EC 안/MAG 먹/VV 었/EP 다고/EC 잡아떼/VV 려면/EC 그냥/MAG 우기/VV 는/ETM 것/NNB 이/JKC 아니/VCN 라/EC
거 아들래미라는 놈이 인두껍을 뒤지버쓴 새끼구만	거/IC 아들내미/NNG 이/VCP 라는/ETM 놈/NNB 이/JKS 인두겁/NNG 을/JKO 뒤집어쓰/VV ᆫ/ETM 새끼/NNG 구만/EF
저 경우에는 반대로 안전밸트를 메서 살았으면 산채로 불타 죽은거잖아	저/MM 경우/NNG 에/JKB 는/JX 반대/NNG 로/JKB 안전벨트/NNG 를/JKO 매/VV 어서/EC 살/VV 었/EP 으면/EC 살/VV ᆫ/ETM 채/NNB 로/JKB 불타/VV 어/EC 죽/VV 은/ETM 거/NNB 잖아/EF
자리바꾸다 여자짝궁 울려본적있음	자리/NNG 바꾸/VV 다/EC 여자/NNG 짝꿍/NNG 울리/VV 어/EC 보/VX ᆫ/ETM 적/NNB 있/VA 음/ETN
못생겨도 성격만 좋으면 왠만하면 자기 짝 찾아서 결혼한다	못생기/VV 어도/EC 성격/NNG 만/JX 좋/VA 으면/EC 웬만/XR 하/XSA 면/EC 자기/NP 짝/NNG 찾/VV 어서/EC 결혼/NNG 하/XSV ᆫ다/EF
기업이라는 전재 자체가 집단 이기주의를 형성하기 아주 좋은 집단임. 이익을 추구하기 위해 모인 집단이고 특히 경제적 이익에 모든게 집중되어 있기 때문에 최대한 손해를 적게 보기 위한 의사결정의 경우에는 아주 쉽게 합의을 도출 할 수 있음.	기업/NNG 이/VCP 라는/ETM 전제/NNG 자체/NNG 가/JKS 집단/NNG 이기주의/NNG 를/JKO 형성/NNG 하/XSV 기/ETN 아주/MAG 좋/VA 은/ETM 집단/NNG 이/VCP ᆷ/ETN ./SF 이익/NNG 을/JKO 추구/NNG 하/XSV 기/ETN 위하/VV 어/EC 모이/VV ᆫ/ETM 집단/NNG 이/VCP 고/EC 특히/MAG 경제/NNG 적/XSN 이익/NNG 에/JKB 모든/MM 것/NNB 이/JKS 집중/NNG 되/XSV 어/EC 있/VX 기/ETN 때문/NNB 에/JKB 최대한/MAG 손해/NNG 를/JKO 적/VA 게/EC 보/VV 기/ETN 위하/VV ᆫ/ETM 의사/NNG 결정/NNG 의/JKG 경우/NNG 에/JKB 는/JX 아주/MAG 쉽/VA-I 게/EC 합의/NNG 를/JKO 도출/NNG 하/XSV ᆯ/ETM 수/NNB 있/VA 음/ETN ./SF
잡아 뗼 수 있으면 사과 안하고 덮어버리는 거고, 명백한 증거가 퍼져있으면 바로 사과 박고 이후에 이미지 개선하는 게 좋지.	잡/VV-R 어/EC 떼/VV ᆯ/ETM 수/NNB 있/VA 으면/EC 사과/NNG 안/MAG 하/VV 고/EC 덮/VV 어/EC 버리/VX 는/ETM 거/NNB 이/VCP 고/EC ,/SP 명백/XR 하/XSA ᆫ/ETM 증거/NNG 가/JKS 퍼지/VV 어/EC 있/VX 으면/EC 바로/MAG 사과/NNG 박/VV 고/EC 이후/NNG 에/JKB 이미지/NNG 개선/NNG 하/XSV 는/ETM 것/NNB 이/JKS 좋/VA 지/EF ./SF
대충 복재인격은 나인가 고찰	대충/MAG 복제/NNG 인격/NNG 은/JX 나/NP 이/VCP ᆫ가/EC 고찰/NNG
베스킨라빈스 경쟁 업체 나뚜르도 롯데고. 그나마 뚜레주르 정도나 선택지 정도	배스킨라빈스/NNP 경쟁/NNG 업체/NNG 나뚜루/NNP 도/JX 롯데/NNP 이/VCP 고/EC ./SF 그나마/MAG 뚜레쥬르/NNP 정도/NNG 나/JC 선택지/NNG 정도/NNG
빵공장 직원들... 재분은 저기서 다해먹는다고 됨 재분계에선 크나큰악임 문제는 차선택도 없다고 보면됨...	빵/NNG 공장/NNG 직원/NNG 들/XSN .../SF 제분/NNG 은/JX 저기/NP 서/JKB 다/MAG 하/VV 어/EC 먹/VX 는다고/EC 되/VV ᆷ/ETN 제분/NNG 계/XSN 에서/JKB ᆫ/JX 크나크/VA ᆫ/ETM 악/NNG 이/VCP ᆷ/ETN 문제/NNG 는/JX 차선책/NNG 도/JX 없/VA 다고/EC 보/VV 면/EC 되/VV ᆷ/ETN .../SF
안티벡신 시위 나가서 연설하기	안티/NNG 백신/NNG 시위/NNG 나가/VV 어서/EC 연설/NNG 하/XSV 기/ETN
나는 급여는 낮아도 워라벨만 지켜주면 다니는데 어지간한 코스탁 기없도 안지켜주더라	나/NP 는/JX 급여/NNG 는/JX 낮/VA 어도/EC 워라밸/NNG 만/JX 지키/VV 어/EC 주/VX 면/EC 다니/VV 는/ETM 데/NNB 어지간/XR 하/XSA ᆫ/ETM 코스닥/NNG 기업/NNG 도/JX 안/MAG 지키/VV 어/EC 주/VX 더라/EF
근데 순수 시장놀리로만 접근하면 안돼는게.. 예를들어 우리나라 농업도 단가 안맞는다고 다 작살내고 외국에 의존했다간	근데/MAJ 순수/NNG 시장/NNG 논리/NNG 로/JKB 만/JX 접근/NNG 하/XSV 면/EC 안/MAG 되/VV 는/ETM 것/NNB 이/JKS ../SF 예/NNG 를/JKO 들/VV 어/EC 우리/NP 나라/NNG 농업/NNG 도/JX 단가/NNG 안/MAG 맞/VV 는다고/EC 다/MAG 작살내/VV 고/EC 외국/NNG 에/JKB 의존/NNG 하/XSV 었/EP 다가/EC ᆫ/JX
내가 지금 친척들이랑 다 인연끈고 사는데 저거 절대로 해주면 안됨	나/NP 가/JKS 지금/MAG 친척/NNG 들/XSN 이랑/JKB 다/MAG 인연/NNG 끊/VV 고/EC 살/VV 는데/EC 저거/NP 절대로/MAG 하/VV 어/EC 주/VX 면/EC 안/MAG 되/XSV ᆷ/ETN
